000 ............32111
001 ............321x1
002 ............32111
003 ............32222
004 ............33333
005 .................
006 .................
007 .................
008 ..-1..............
009 ..-1-1.............
010 .................
011 .................
012 .............-2-2..
013 .................
014 .................